################
#              #
####### ########
#####   ########
####  ##########
####  ##########
####  ##########
####        ####
########### ####
####   ##    ###
#####  ###  ####
##### #### #####
##### ###  #####
#### #### ######
       ## ######
       ## ######
#########   ####
#########*######